NO ./path_to_the_north_texture
SO ./path_to_the_south_texture
WE ./path_to_the_west_texture
EA ./path_to_the_east_texture

F 220,100,0
C 225,30,0


 11111111111111111111111
1000000000110000000000001
1N11000001110000000000001
 1001000000000000000000001
111111111011000001110000011111111
100000000011000001110111111111111
11110111111111011100000000001
11110111111111011101010010001
11000000110101011100000010001
11000000110101011100000010001
11000000110101011100000010001
11000000110101011100000010001
11000000110101011100000010001
11000000110101011100000010001
11000000110101011100000010001
11000000110101011100000010001
11000000110101011100000010001
11000000110101011100000010001
11000000110101011100000010001
11000000110101011100000010001
11000000110101011100000010001
11000000110101011100000010001
11000000110101011100000010001
10000000000000001100000010001
1000000000000000110101010001
1100000111010101111101111000111
11110111 1110101 101111010001
11111111 1111111 11111111111
