NO textures/north.xpm
SO textures/south.xpm
WE textures/west.xpm
EA textures/east.xpm


F 160,108,30
C 119,181,254

111111111111111
111111000111111
111110000011111
1111000N0001111
111000000000111
110000000000011
110000000000011
110000000000011
110000111000011
111000010000111
111100000001111
111110000011111
111111000111111
111111111111111
