NO textures/north.xpm
SO textures/south.xpm
WE textures/west.xpm
EA textures/east.xpm

F 160,108,30
C 119,181,254

11111
10W01
11111