NO textures/north.xpm
SO textures/south.xpm
WE textures/west.xpm
EA textures/east.xpm

F 160,108,30
C 119,181,254

111111111111111111111
1000000000000000000N1
111111111111111111111